1111111
1100P01
1E000C1
1100001
1111111