111111111111111111111111111111
10000000000000P000000000000001
101111111111110111111111111101
101000000000000000000000000101
1010CCCCCCCCCCCCCCCCCCCCCC0101
1010CCCCCCCCCCCCCCCCCCCCCC0101
101000000000000000000000000101
101111111111111111111111111101
10000000000000E000000000000001
111111111111111111111111111111


