11111111111111111111
1E000000000000000001
10000000000000000001
1C001111111111111101
10000000000000000001
1P000000000000000000
11111111111111111111